2
Puzzle
30
0
2
1
1
40
60
0
0
0
0
0
50
50
1,32,22,31,21,32,32,20,02,2
2,22,32,32,22,21,32,32,22,3
0,02,21,21,31,21,20,02,21,2
2,30,02,32,31,21,31,22,31,3
2,32,32,32,32,21,21,32,31,2
2,32,32,21,32,22,31,31,30,0
2,31,22,22,21,31,32,32,22,2
1,32,32,21,32,30,01,32,32,2
0,02,32,31,21,22,31,22,22,2
