3
Release
100
20
10
10
10
100
0
0
0
0
0
0
0
100
1,36,31,36,31,31,31,36,36,3
6,31,36,31,36,31,36,31,31,3
1,31,31,31,31,36,31,31,31,3
1,31,31,31,31,31,31,31,31,3
1,31,31,31,31,31,31,31,31,3
1,31,31,31,31,31,31,31,31,3
1,31,31,31,31,31,31,31,31,3
1,31,31,31,31,31,31,31,31,3
*,**,**,**,**,**,**,**,**,*
