10
Lightning
0
120
2
3
1
15
20
20
20
10
15
75
15
10
4,12,16,11,13,12,14,34,23,1
1,15,23,12,13,16,11,13,11,1
5,11,35,12,12,13,13,16,12,1
4,14,33,11,11,16,23,14,35,1
2,12,16,36,12,16,24,15,11,1
2,16,14,11,23,31,13,15,12,1
3,11,15,16,14,11,13,11,11,1
4,12,12,23,15,11,14,12,12,1
6,12,15,33,11,11,14,16,12,2
2000
3000
5000
