6
Lightning
16
200
2
3
1
20
20
20
20
10
10
75
15
10
6,11,13,13,14,14,13,14,32,1
4,13,13,11,12,25,12,16,16,2
3,12,11,11,13,15,21,11,12,3
1,11,12,11,13,11,14,11,16,1
3,14,13,22,15,13,12,12,11,1
6,12,14,12,14,15,13,21,14,1
5,21,31,12,11,13,31,24,15,1
2,11,13,36,23,15,11,12,33,2
4,33,34,13,15,23,13,11,15,3
2000
3000
4000