7
Lightning
16
200
2
3
1
20
20
20
20
10
10
75
15
10
2,14,12,12,13,14,14,15,16,1
2,14,11,14,15,11,34,11,23,1
4,21,33,11,14,35,12,22,11,1
1,25,24,14,15,16,12,12,14,1
3,15,23,15,14,12,25,16,15,1
4,14,16,12,14,13,14,15,15,1
1,26,11,14,12,15,24,14,34,1
4,32,14,31,14,14,31,12,14,1
4,16,13,13,25,26,11,12,14,1
2000
3000
4000