4
Elimination
0
0
2
3
1
100
0
0
0
0
0
0
0
100
1,31,31,31,31,31,31,31,31,3
0,01,31,31,31,31,31,31,31,3
1,31,31,31,31,31,31,31,31,3
1,31,31,31,31,31,31,31,31,3
1,31,31,31,30,01,31,31,31,3
1,31,31,30,01,30,01,31,31,3
1,31,31,30,01,30,01,31,31,3
1,31,31,31,30,01,31,31,31,3
0,01,31,31,31,31,31,31,31,3
2000
3000
4000
