14
Lightning
0
100
2
3
1
20
20
20
20
10
10
50
10
40
3,32,15,36,32,14,35,31,16,1
5,11,13,12,35,31,36,34,34,3
2,36,12,11,35,32,32,15,31,3
3,32,11,15,32,13,34,11,14,3
4,31,11,26,21,32,33,11,16,1
3,33,11,33,34,31,14,10,01,3
3,14,15,11,11,11,31,11,24,1
3,16,15,22,13,12,13,11,32,3
1,12,34,31,13,34,11,12,14,1
2000
3000
4000
