4
Elimination
0
0
2
3
1
20
20
20
20
10
10
50
25
25
4,22,11,23,13,24,14,21,12,1
0,04,12,35,12,11,14,11,11,2
2,24,34,32,24,23,12,15,12,1
1,14,15,35,16,33,16,11,12,1
3,34,16,13,10,02,12,16,11,2
1,15,15,10,03,10,04,23,12,3
1,32,12,20,04,10,04,12,12,1
2,14,12,14,30,01,36,12,11,1
0,01,16,12,25,12,32,16,22,1
2000
3000
4000
