5
Puzzle
18
0
2
3
1
15
15
10
20
20
20
25
25
50
5,12,13,12,12,16,12,24,16,1
5,11,21,15,12,23,25,13,24,1
4,13,15,11,14,14,16,34,14,1
4,16,11,13,12,14,34,11,14,1
5,15,31,13,15,12,16,22,21,1
3,11,11,16,25,24,12,36,11,3
5,13,13,13,25,35,13,25,26,1
5,15,12,22,11,35,14,16,13,1
5,14,15,16,33,11,14,12,13,1
2000
3000
5000
