12
Elimination
0
0
2
3
1
20
20
20
20
10
10
25
50
25
0,04,15,22,12,15,22,30,00,0
0,04,16,34,16,21,24,31,30,0
3,12,31,15,14,21,22,15,23,1
6,34,31,33,21,34,16,33,32,2
2,24,14,22,20,02,11,33,15,2
4,12,24,20,03,10,04,15,11,1
5,13,22,10,05,10,03,24,12,2
2,14,16,13,30,03,10,00,06,2
0,03,11,15,32,21,32,15,30,0
2000
3000
4000
