2
Lightning
0
20
10
10
1
25
5
25
10
10
5
0
0
100
1,31,31,31,31,31,31,30,01,3
1,31,31,31,31,31,31,31,31,3
0,01,31,31,31,31,30,01,31,3
1,30,01,31,31,31,31,31,31,3
1,31,31,31,31,31,31,31,31,3
1,31,31,31,31,31,31,31,30,0
1,31,31,31,31,31,31,31,31,3
1,31,31,31,31,30,01,31,31,3
0,01,31,31,31,31,31,31,31,3
2000
3000
4000
