13
Lightning
16
200
2
3
1
20
20
20
20
10
10
75
15
10
3,13,13,13,13,13,13,13,13,1
1,11,11,11,11,11,11,11,11,1
1,11,11,11,11,11,11,11,11,1
1,11,11,11,11,11,11,11,11,1
1,21,11,11,11,11,11,11,11,1
1,11,11,11,11,11,11,11,11,1
1,11,11,11,11,11,11,11,11,1
1,11,11,11,11,11,11,11,11,1
2,12,12,12,12,12,12,12,12,1
2000
3000
4000
