2
Lightning
0
200
10
10
1
40
60
0
0
0
0
0
50
50
1,22,22,22,22,22,21,30,01,2
2,31,32,32,22,32,22,22,31,2
0,02,32,21,31,31,30,02,31,3
2,30,01,32,22,21,21,32,22,2
2,32,32,32,31,32,21,32,31,2
1,32,21,32,32,22,22,21,20,0
2,21,32,21,31,31,31,22,32,2
2,32,31,22,32,30,02,32,31,3
0,02,21,31,32,22,22,32,21,3
2000
3000
4000
