8
Elimination
0
0
5
5
0
100
0
0
0
0
0
40
20
40
1,31,11,11,11,31,31,31,11,1
1,11,11,11,21,31,11,11,11,1
1,31,31,11,11,31,31,11,31,1
1,31,31,31,21,31,11,11,31,2
1,31,11,31,11,31,21,11,31,3
1,11,11,11,21,11,31,31,31,1
1,11,31,31,11,11,11,11,31,3
1,11,31,11,11,31,21,11,11,2
1,11,11,21,11,31,11,31,31,3
