9
Elimination
0
0
5
5
0
30
30
25
15
0
0
0
0
100
2,31,31,31,32,32,32,32,33,3
1,31,34,30,00,00,01,33,34,3
1,32,30,04,34,33,30,01,31,3
4,30,03,32,32,33,31,30,02,3
1,30,03,33,33,32,33,30,03,3
4,33,30,03,34,31,30,02,33,3
2,32,33,30,00,00,03,31,31,3
4,32,33,34,31,31,32,31,31,3
2,31,33,33,31,32,32,34,33,3
2000
3000
4000