13
Puzzle
14
0
2
3
1
20
20
20
20
10
10
30
30
40
1,12,14,12,32,11,13,34,16,1
3,34,12,36,13,32,15,16,14,1
1,33,11,35,11,34,12,12,14,3
4,34,11,32,14,31,11,12,11,3
4,14,34,31,13,16,15,15,16,1
2,12,34,33,15,16,14,12,13,1
3,16,13,14,16,14,12,33,13,1
3,36,32,14,15,13,15,14,14,3
1,16,33,13,11,34,14,12,13,3
2000
3000
4000
