1
Puzzle
20
0
2
3
1
15
20
20
20
10
15
75
15
10
3,13,25,14,14,35,13,12,13,1
1,23,34,16,14,15,12,14,13,1
3,11,13,13,15,12,11,14,15,1
1,15,31,12,12,14,15,12,12,1
2,12,13,12,26,14,11,14,15,1
2,11,26,12,21,11,16,14,23,1
2,11,11,25,11,12,12,13,25,1
6,13,16,12,12,13,21,12,24,1
3,12,13,36,16,15,31,12,16,1
2000
3000
5000
