9
Puzzle
16
0
5
5
0
30
30
25
15
0
0
0
0
100
1,31,33,31,31,32,31,32,32,3
2,34,34,30,00,00,02,34,34,3
3,31,30,01,32,33,30,02,34,3
4,30,04,33,32,33,33,30,02,3
1,30,02,33,32,32,31,30,01,3
2,34,30,03,33,31,30,01,31,3
3,32,32,30,00,00,01,32,32,3
1,34,32,32,31,34,33,34,34,3
1,33,33,32,32,34,34,31,31,3
2000
3000
4000
