16
Elimination
0
0
2
3
1
15
20
20
20
10
15
50
10
40
6,13,11,34,13,15,13,33,21,3
6,14,15,11,24,34,13,12,11,1
3,34,16,14,16,13,14,14,15,2
6,26,30,00,00,00,00,03,33,1
3,32,10,00,00,00,00,01,15,2
4,16,10,00,00,00,00,01,12,1
4,14,14,23,14,12,13,11,13,2
6,13,11,36,16,12,14,11,14,2
1,12,21,22,14,13,11,11,13,1
2000
3000
5000
