8
Elimination
0
0
5
5
0
100
0
0
0
0
0
40
20
40
1,31,11,11,10,01,31,31,11,1
1,11,11,11,20,01,11,11,11,1
1,31,31,11,10,01,31,11,31,1
1,31,31,31,20,01,11,11,31,2
1,31,11,31,10,01,21,11,31,3
1,11,11,11,20,01,31,31,31,1
1,11,31,31,10,01,11,11,31,3
1,11,31,11,10,01,21,11,11,2
0,00,00,00,00,00,00,00,00,0
2000
3000
4000
