5
Lightning
16
200
2
3
1
20
20
20
20
10
10
75
15
10
2,14,23,12,14,12,26,14,15,3
3,13,11,11,12,11,12,32,13,1
4,12,14,15,14,12,12,25,11,1
1,14,11,14,11,16,11,14,12,3
6,23,32,31,13,35,13,15,14,1
5,12,12,13,12,26,11,31,26,1
1,11,35,13,12,13,11,11,36,1
2,15,12,14,14,12,13,16,24,1
4,31,15,14,11,11,26,12,23,1
