6
Lightning
0
200
2
3
1
20
20
20
20
10
10
75
15
10
2,12,12,12,21,13,22,21,34,1
2,13,13,14,11,12,12,12,14,2
2,12,34,13,35,15,15,11,12,2
1,15,11,11,16,12,13,25,24,1
2,16,13,15,11,24,12,24,14,1
0,00,02,23,10,04,10,04,30,0
0,02,10,00,01,10,00,00,00,0
0,00,05,10,00,00,00,00,00,0
0,04,12,10,03,10,00,03,10,0
2000
3000
4000
